Denna film framstod som mest utmärkt igår kväll	positiv
Skådespelet blev lite väl halvbra idag	neutral
Denna film upplevdes som välgjord	positiv
Dialogen upplevdes som ganska underbar	positiv
Regin var mest alldaglig från början till slut	neutral
Slutet kändes väldigt ointressant i sin helhet	negativ
Regin blev alldeles för dålig	negativ
Handlingen upplevdes som riktigt rörig att titta på	negativ
Regin kändes riktigt okej att titta på	neutral
Skådespelet framstod som lite väl dålig i biosalongen	negativ
Manuset kändes riktigt rörig i sin helhet	negativ
Regin upplevdes som lite väl magisk	positiv
Handlingen blev lite väl platt	negativ
Filmen framstod som lite väl bedrövlig	negativ
Rullen var riktigt värdelös för min smak	negativ
Upplevelsen var helt acceptabel idag	neutral
Berättelsen var otroligt mäktig att titta på	positiv
Slutet framstod som helt välgjord i sin helhet	positiv
Rullen blev ganska passabel hela tiden	neutral
Hela filmen blev lite väl seg i biosalongen	negativ
Rullen verkade alldeles för typisk	neutral
Hela filmen var alldeles för dålig	negativ
Rullen verkade alldeles för vanlig	neutral
Rullen upplevdes som ganska lysande	positiv
Hela filmen blev mest spännande i sin helhet	positiv
Rullen upplevdes som mest långtråkig hela tiden	negativ
Berättelsen upplevdes som riktigt lagom idag	neutral
Skådespelet upplevdes som faktiskt seg	negativ
Slutet var lite väl lysande för min smak	positiv
Filmen var otroligt acceptabel hela tiden	neutral
Upplevelsen upplevdes som faktiskt värdelös	negativ
Regin framstod som mest rolig	positiv
Handlingen blev otroligt värdelös utan tvekan	negativ
Slutet framstod som ganska fruktansvärd	negativ
Regin framstod som otroligt platt	negativ
Dialogen framstod som alldeles för som väntat idag	neutral
Regin kändes alldeles för acceptabel i biosalongen	neutral
Hela filmen framstod som medel	neutral
Skådespelet framstod som faktiskt bedrövlig att titta på	negativ
Berättelsen upplevdes som väldigt godkänd utan tvekan	neutral
Dialogen framstod som otroligt platt i sin helhet	negativ
Dialogen blev helt mäktig i sin helhet	positiv
Hela filmen var väldigt typisk	neutral
Rullen verkade riktigt magisk utan tvekan	positiv
Filmen blev lite väl lagom idag	neutral
Slutet kändes riktigt mäktig igår kväll	positiv
Hela filmen blev faktiskt magisk på alla sätt	positiv
Regin framstod som alldeles för värdelös utan tvekan	negativ
Skådespelet upplevdes som som väntat	neutral
Berättelsen verkade ganska lysande idag	positiv
Filmen upplevdes som riktigt tråkig	negativ
Upplevelsen var mest medel på alla sätt	neutral
Dialogen upplevdes som faktiskt dålig	negativ
Denna film upplevdes som faktiskt okej hela tiden	neutral
Rullen verkade otroligt halvbra att titta på	neutral
Upplevelsen kändes lite väl passabel hela tiden	neutral
Dialogen verkade mest vanlig hela tiden	neutral
Denna film blev faktiskt dålig för min smak	negativ
Rullen blev väldigt underbar för min smak	positiv
Filmen framstod som faktiskt lysande	positiv
Hela filmen verkade väldigt underbar i biosalongen	positiv
Hela filmen blev alldeles för rolig i biosalongen	positiv
Slutet kändes faktiskt usel hela tiden	negativ
Berättelsen var otroligt lysande från början till slut	positiv
Handlingen var alldeles för fruktansvärd	negativ
Denna film blev helt som väntat	neutral
Slutet verkade helt magisk för min smak	positiv
Upplevelsen blev helt stark i biosalongen	positiv
Manuset blev helt gripande att titta på	positiv
Regin upplevdes som lite väl okej igår kväll	neutral
Berättelsen var riktigt spännande från början till slut	positiv
Berättelsen upplevdes som lite väl ointressant	negativ
Rullen var ganska godkänd idag	neutral
Rullen framstod som faktiskt utmärkt utan tvekan	positiv
Rullen kändes otroligt fånig att titta på	negativ
Denna film upplevdes som lite väl mäktig	positiv
Denna film framstod som ganska godkänd utan tvekan	neutral
Berättelsen var lite väl lysande	positiv
Dialogen verkade lite väl rörig i sin helhet	negativ
Rullen var otroligt fruktansvärd hela tiden	negativ
Manuset framstod som otroligt okej i sin helhet	neutral
Dialogen framstod som lite väl magisk	positiv
Dialogen verkade väldigt som väntat igår kväll	neutral
Filmen upplevdes som väldigt långtråkig	negativ
Filmen upplevdes som helt spännande att titta på	positiv
Upplevelsen framstod som alldeles för okej	neutral
Denna film framstod som alldeles för stark	positiv
Skådespelet blev alldeles för typisk i sin helhet	neutral
Upplevelsen verkade ganska rolig igår kväll	positiv
Hela filmen framstod som lite väl bedrövlig	negativ
Berättelsen kändes otroligt fruktansvärd igår kväll	negativ
Upplevelsen kändes ganska ointressant för min smak	negativ
Skådespelet verkade lite väl lagom idag	neutral
Berättelsen verkade otroligt medel för min smak	neutral
Berättelsen upplevdes som väldigt halvbra igår kväll	neutral
Dialogen upplevdes som ganska rörig utan tvekan	negativ
Regin verkade lite väl okej utan tvekan	neutral
Rullen kändes mest smart för min smak	positiv
Slutet upplevdes som mest usel	negativ
Regin var faktiskt okej i biosalongen	neutral
Denna film framstod som riktigt ointressant	negativ
Skådespelet var väldigt vanlig utan tvekan	neutral
Regin upplevdes som alldeles för magisk	positiv
Filmen blev mest rörig utan tvekan	negativ
Manuset framstod som som väntat	neutral
Berättelsen blev alldeles för medel idag	neutral
Denna film verkade riktigt smart	positiv
Hela filmen kändes faktiskt underbar i biosalongen	positiv
Filmen upplevdes som mest godkänd	neutral
Rullen blev ganska lagom på alla sätt	neutral
Slutet framstod som otroligt stark	positiv
Manuset var lite väl stark för min smak	positiv
Denna film framstod som riktigt seg	negativ
Manuset var alldeles för lysande	positiv
Filmen verkade alldeles för långtråkig att titta på	negativ
Denna film upplevdes som bedrövlig	negativ
Slutet blev alldeles för stark i sin helhet	positiv
Slutet blev väldigt magisk att titta på	positiv
Rullen var mest som väntat	neutral
Slutet var otroligt värdelös igår kväll	negativ
Handlingen blev mest usel från början till slut	negativ
Upplevelsen blev lite väl bedrövlig	negativ
Filmen blev helt dålig igår kväll	negativ
Berättelsen framstod som riktigt rolig för min smak	positiv
Denna film framstod som godkänd	neutral
Denna film kändes väldigt fantastisk att titta på	positiv
Upplevelsen framstod som lite väl välgjord	positiv
Berättelsen verkade alldeles för spännande	positiv
Regin upplevdes som otroligt medel	neutral
Filmen upplevdes som otroligt mäktig igår kväll	positiv
Filmen kändes alldeles för alldaglig att titta på	neutral
Regin upplevdes som helt lysande idag	positiv
Filmen blev väldigt fruktansvärd idag	negativ
Slutet var riktigt underbar för min smak	positiv
Regin blev mest okej idag	neutral
Denna film kändes väldigt värdelös att titta på	negativ
Handlingen kändes faktiskt medel idag	neutral
Handlingen var ganska alldaglig idag	neutral
Manuset framstod som mest passabel	neutral
Slutet verkade faktiskt som väntat	neutral
Berättelsen blev lite väl godkänd igår kväll	neutral
Skådespelet verkade faktiskt värdelös utan tvekan	negativ
Skådespelet verkade faktiskt välgjord på alla sätt	positiv
Upplevelsen verkade alldeles för utmärkt igår kväll	positiv
Berättelsen verkade lite väl rolig i biosalongen	positiv
Rullen upplevdes som ganska fånig i biosalongen	negativ
Skådespelet kändes lite väl fruktansvärd på alla sätt	negativ
Denna film var alldeles för rolig	positiv
Slutet framstod som faktiskt fantastisk	positiv
Manuset upplevdes som riktigt tråkig för min smak	negativ
Manuset framstod som helt magisk	positiv
Denna film framstod som halvbra	neutral
Regin upplevdes som mest värdelös för min smak	negativ
Skådespelet blev väldigt bedrövlig att titta på	negativ
Regin verkade otroligt alldaglig på alla sätt	neutral
Berättelsen verkade helt långtråkig igår kväll	negativ
Berättelsen upplevdes som otroligt rolig	positiv
Rullen blev väldigt lysande i sin helhet	positiv
Skådespelet upplevdes som otroligt godkänd	neutral
Dialogen framstod som lite väl medel	neutral
Manuset framstod som riktigt långtråkig på alla sätt	negativ
Regin kändes alldeles för fantastisk	positiv
Slutet var helt fånig igår kväll	negativ
Manuset blev lite väl typisk	neutral
Slutet upplevdes som ganska seg igår kväll	negativ
Manuset blev lite väl spännande	positiv
Denna film verkade faktiskt acceptabel	neutral
Slutet framstod som mest rolig idag	positiv
Filmen verkade ganska rolig från början till slut	positiv
Berättelsen kändes otroligt magisk igår kväll	positiv
Rullen blev otroligt mäktig hela tiden	positiv
Berättelsen framstod som alldeles för värdelös	negativ
Skådespelet var mest rolig idag	positiv
Hela filmen framstod som helt dålig i biosalongen	negativ
Hela filmen verkade lite väl välgjord hela tiden	positiv
Slutet blev mest bedrövlig igår kväll	negativ
Dialogen blev alldeles för stark	positiv
Upplevelsen framstod som riktigt tråkig	negativ
Regin upplevdes som mest värdelös	negativ
Filmen framstod som som väntat	neutral
Handlingen verkade alldeles för ointressant	negativ
Dialogen verkade lite väl passabel	neutral
Hela filmen framstod som dålig	negativ
Regin var faktiskt smart idag	positiv
Handlingen kändes alldeles för seg utan tvekan	negativ
Dialogen verkade väldigt lysande att titta på	positiv
Regin kändes alldeles för passabel	neutral
Handlingen framstod som faktiskt långtråkig i biosalongen	negativ
Denna film blev faktiskt som väntat	neutral
Slutet var riktigt alldaglig i biosalongen	neutral
Skådespelet upplevdes som helt bedrövlig utan tvekan	negativ
Filmen blev otroligt rolig igår kväll	positiv
Berättelsen framstod som lite väl spännande	positiv
Manuset upplevdes som ganska spännande att titta på	positiv
Handlingen verkade ganska dålig på alla sätt	negativ
Filmen blev väldigt bedrövlig igår kväll	negativ
Denna film upplevdes som medel	neutral
Hela filmen blev riktigt magisk	positiv
Berättelsen framstod som lite väl gripande igår kväll	positiv
Upplevelsen kändes riktigt platt från början till slut	negativ
Denna film upplevdes som alldeles för fantastisk	positiv
Skådespelet kändes otroligt vanlig från början till slut	neutral
Hela filmen upplevdes som värdelös	negativ
Handlingen framstod som alldeles för dålig	negativ
Hela filmen var otroligt magisk för min smak	positiv
Manuset verkade otroligt mäktig utan tvekan	positiv
Hela filmen blev ganska magisk idag	positiv
Dialogen blev alldeles för acceptabel i sin helhet	neutral
Upplevelsen var lite väl typisk i biosalongen	neutral
Denna film framstod som faktiskt alldaglig	neutral
Filmen verkade riktigt bedrövlig utan tvekan	negativ
Dialogen var alldeles för seg för min smak	negativ
Handlingen framstod som otroligt seg utan tvekan	negativ
Manuset upplevdes som ganska fruktansvärd	negativ
Manuset var riktigt värdelös på alla sätt	negativ
Filmen blev mest gripande från början till slut	positiv
Hela filmen var helt medel	neutral
Hela filmen verkade mest medel idag	neutral
Filmen framstod som väldigt ointressant idag	negativ
Regin upplevdes som helt alldaglig för min smak	neutral
Berättelsen verkade faktiskt lagom på alla sätt	neutral
Manuset upplevdes som ganska typisk för min smak	neutral
Berättelsen kändes lite väl halvbra	neutral
Denna film upplevdes som ganska bedrövlig	negativ
Rullen blev helt utmärkt hela tiden	positiv
Filmen upplevdes som väldigt alldaglig att titta på	neutral
Manuset upplevdes som ganska vanlig	neutral
Filmen blev helt fantastisk utan tvekan	positiv
Regin var ganska magisk från början till slut	positiv
Manuset upplevdes som väldigt långtråkig	negativ
Berättelsen blev helt som väntat	neutral
Rullen var riktigt medel på alla sätt	neutral
Regin var mest tråkig idag	negativ
Denna film blev riktigt rörig att titta på	negativ
Hela filmen upplevdes som lagom	neutral
Skådespelet upplevdes som lite väl dålig	negativ
Hela filmen upplevdes som halvbra	neutral
Upplevelsen var alldeles för typisk idag	neutral
Hela filmen var väldigt magisk	positiv
Berättelsen blev lite väl lagom utan tvekan	neutral
Denna film framstod som väldigt platt igår kväll	negativ
Berättelsen framstod som lite väl medel	neutral
Skådespelet verkade alldeles för halvbra i sin helhet	neutral
Rullen upplevdes som faktiskt dålig	negativ
Dialogen kändes otroligt bedrövlig att titta på	negativ
Regin framstod som mest gripande	positiv
Skådespelet blev otroligt acceptabel igår kväll	neutral
Dialogen upplevdes som alldeles för lysande igår kväll	positiv
Filmen verkade väldigt fantastisk för min smak	positiv
Skådespelet verkade ganska medel idag	neutral
Dialogen var väldigt mäktig för min smak	positiv
Filmen kändes faktiskt vanlig igår kväll	neutral
Hela filmen kändes helt underbar	positiv
Denna film verkade väldigt acceptabel	neutral
Filmen upplevdes som riktigt gripande igår kväll	positiv
Handlingen var alldeles för utmärkt i sin helhet	positiv
Hela filmen var riktigt fånig	negativ
Berättelsen verkade lite väl långtråkig	negativ
Denna film upplevdes som helt rolig hela tiden	positiv
Manuset upplevdes som helt långtråkig	negativ
Manuset var lite väl medel att titta på	neutral
Filmen kändes alldeles för långtråkig igår kväll	negativ
Regin framstod som faktiskt spännande	positiv
Handlingen upplevdes som lite väl stark	positiv
Denna film verkade otroligt passabel	neutral
Denna film framstod som fruktansvärd	negativ
Handlingen kändes väldigt passabel för min smak	neutral
Handlingen kändes alldeles för gripande på alla sätt	positiv
Berättelsen var ganska passabel i sin helhet	neutral
Slutet upplevdes som riktigt tråkig i sin helhet	negativ
Dialogen var otroligt magisk från början till slut	positiv
Hela filmen var alldeles för långtråkig	negativ
Berättelsen framstod som helt magisk	positiv
Manuset var väldigt tråkig för min smak	negativ
Denna film upplevdes som helt utmärkt hela tiden	positiv
Hela filmen kändes väldigt dålig igår kväll	negativ
Dialogen verkade helt tråkig från början till slut	negativ
Hela filmen verkade alldeles för medel igår kväll	neutral
Rullen blev helt välgjord idag	positiv
Denna film blev otroligt halvbra	neutral
Skådespelet kändes otroligt godkänd idag	neutral
Regin var helt långtråkig för min smak	negativ
Rullen var otroligt ointressant utan tvekan	negativ
Manuset kändes alldeles för spännande	positiv
Handlingen var alldeles för rolig	positiv
Regin kändes väldigt fånig i sin helhet	negativ
Upplevelsen upplevdes som ganska smart	positiv
Hela filmen upplevdes som riktigt mäktig	positiv
Manuset verkade helt rörig för min smak	negativ
Filmen upplevdes som mest långtråkig	negativ
Hela filmen upplevdes som ganska spännande	positiv
Upplevelsen blev otroligt smart hela tiden	positiv
Rullen upplevdes som helt alldaglig	neutral
Skådespelet upplevdes som alldeles för bedrövlig hela tiden	negativ
Handlingen framstod som faktiskt typisk igår kväll	neutral
Slutet framstod som lite väl spännande	positiv
Handlingen blev alldeles för bedrövlig i sin helhet	negativ
Manuset blev otroligt ointressant idag	negativ
Rullen blev väldigt rolig på alla sätt	positiv
Hela filmen upplevdes som passabel	neutral
Upplevelsen upplevdes som faktiskt seg	negativ
Handlingen verkade väldigt okej idag	neutral
Skådespelet kändes väldigt typisk i sin helhet	neutral
Upplevelsen kändes alldeles för typisk hela tiden	neutral
Denna film blev väldigt välgjord	positiv
Berättelsen framstod som faktiskt utmärkt hela tiden	positiv
Filmen blev lite väl mäktig	positiv
Denna film upplevdes som alldeles för passabel	neutral
Rullen framstod som helt vanlig	neutral
Filmen blev lite väl seg idag	negativ
Hela filmen upplevdes som fånig	negativ
Upplevelsen verkade faktiskt fantastisk idag	positiv
Filmen blev otroligt dålig i biosalongen	negativ
Berättelsen blev helt fruktansvärd att titta på	negativ
Skådespelet kändes riktigt magisk i biosalongen	positiv
Denna film verkade riktigt godkänd	neutral
Regin upplevdes som ganska ointressant i biosalongen	negativ
Manuset var alldeles för välgjord hela tiden	positiv
Berättelsen upplevdes som mest fruktansvärd igår kväll	negativ
Regin blev alldeles för godkänd för min smak	neutral
Manuset verkade mest rörig utan tvekan	negativ
Handlingen framstod som väldigt seg i biosalongen	negativ
Denna film verkade ganska halvbra i biosalongen	neutral
Hela filmen blev mest välgjord i biosalongen	positiv
Upplevelsen upplevdes som riktigt spännande igår kväll	positiv
Upplevelsen blev faktiskt rolig i biosalongen	positiv
Rullen upplevdes som riktigt dålig	negativ
Denna film verkade ganska medel	neutral
Filmen var faktiskt acceptabel utan tvekan	neutral
Upplevelsen verkade lite väl magisk på alla sätt	positiv
Hela filmen upplevdes som helt bedrövlig	negativ
Regin var faktiskt godkänd att titta på	neutral
Slutet framstod som väldigt mäktig utan tvekan	positiv
Filmen framstod som helt fantastisk hela tiden	positiv
Regin var faktiskt halvbra utan tvekan	neutral
Dialogen blev lite väl typisk	neutral
Skådespelet verkade lite väl medel	neutral
Regin upplevdes som ganska lagom i biosalongen	neutral
Manuset kändes faktiskt alldaglig på alla sätt	neutral
Denna film verkade faktiskt underbar	positiv
Dialogen upplevdes som mest acceptabel	neutral
Dialogen framstod som otroligt okej	neutral
Slutet blev faktiskt spännande igår kväll	positiv
Berättelsen upplevdes som otroligt usel	negativ
Regin var ganska lagom från början till slut	neutral
Denna film verkade lite väl ointressant	negativ
Hela filmen framstod som usel	negativ
Slutet upplevdes som alldeles för bedrövlig	negativ
Rullen var lite väl fruktansvärd i sin helhet	negativ
Denna film verkade riktigt medel	neutral
Rullen framstod som riktigt fånig i biosalongen	negativ
Upplevelsen var lite väl ointressant	negativ
Rullen framstod som mest välgjord	positiv
Denna film framstod som medel	neutral
Slutet blev ganska gripande att titta på	positiv
Skådespelet var riktigt utmärkt idag	positiv
Slutet blev ganska gripande från början till slut	positiv
Slutet var lite väl gripande i biosalongen	positiv
Manuset var ganska som väntat	neutral
Upplevelsen framstod som helt lysande för min smak	positiv
Regin kändes ganska mäktig i biosalongen	positiv
Manuset upplevdes som otroligt halvbra för min smak	neutral
Denna film verkade otroligt typisk	neutral
Upplevelsen framstod som mest välgjord	positiv
Slutet framstod som mest platt att titta på	negativ
Upplevelsen framstod som mest tråkig igår kväll	negativ
Hela filmen kändes riktigt lagom	neutral
Berättelsen upplevdes som mest medel	neutral
Handlingen blev alldeles för lysande i biosalongen	positiv
Filmen framstod som alldeles för acceptabel hela tiden	neutral
Manuset blev väldigt okej i biosalongen	neutral
Manuset upplevdes som riktigt godkänd	neutral
Manuset framstod som ganska godkänd	neutral
Hela filmen blev mest tråkig i sin helhet	negativ
Rullen blev ganska bedrövlig igår kväll	negativ
Handlingen framstod som faktiskt medel	neutral
Manuset blev lite väl välgjord	positiv
Manuset var mest usel att titta på	negativ
Denna film blev väldigt fånig idag	negativ
Skådespelet var mest magisk i sin helhet	positiv
Hela filmen framstod som ganska gripande igår kväll	positiv
Manuset blev otroligt halvbra idag	neutral
Upplevelsen blev väldigt rolig igår kväll	positiv
Filmen upplevdes som faktiskt tråkig	negativ
Dialogen framstod som alldeles för rolig	positiv
Rullen framstod som otroligt rolig i biosalongen	positiv
Denna film kändes helt ointressant	negativ
Skådespelet verkade alldeles för gripande hela tiden	positiv
Handlingen verkade helt lysande igår kväll	positiv
Rullen upplevdes som mest lagom i sin helhet	neutral
Berättelsen kändes ganska acceptabel i sin helhet	neutral
Handlingen blev lite väl magisk	positiv
Manuset blev alldeles för gripande att titta på	positiv
Hela filmen blev ganska ointressant	negativ
Regin upplevdes som helt halvbra att titta på	neutral
Slutet upplevdes som väldigt dålig	negativ
Filmen framstod som ganska gripande	positiv
Dialogen blev helt fånig från början till slut	negativ
Skådespelet framstod som otroligt typisk på alla sätt	neutral
Skådespelet blev helt som väntat	neutral
Upplevelsen kändes mest tråkig på alla sätt	negativ
Berättelsen var lite väl välgjord	positiv
Dialogen blev alldeles för magisk	positiv
Denna film framstod som riktigt värdelös	negativ
Hela filmen blev ganska utmärkt	positiv
Regin var helt värdelös i biosalongen	negativ
Dialogen var väldigt passabel från början till slut	neutral
Rullen verkade lite väl utmärkt	positiv
Filmen var alldeles för magisk på alla sätt	positiv
Dialogen blev helt lagom utan tvekan	neutral
Hela filmen var lite väl lysande	positiv
Regin var lite väl värdelös	negativ
Berättelsen kändes riktigt halvbra igår kväll	neutral
Hela filmen blev mest rolig i biosalongen	positiv
Regin var lite väl tråkig	negativ
Skådespelet blev alldeles för rörig på alla sätt	negativ
Upplevelsen framstod som faktiskt lysande idag	positiv
Slutet upplevdes som lite väl rolig i biosalongen	positiv
Rullen verkade alldeles för mäktig utan tvekan	positiv
Dialogen kändes riktigt långtråkig hela tiden	negativ
Regin blev helt utmärkt idag	positiv
Skådespelet blev ganska fånig idag	negativ
Berättelsen upplevdes som helt fånig för min smak	negativ
Filmen var faktiskt okej i biosalongen	neutral
Hela filmen kändes faktiskt passabel	neutral
Handlingen upplevdes som lite väl lagom	neutral
Hela filmen var helt fånig	negativ
Dialogen framstod som väldigt alldaglig på alla sätt	neutral
Manuset upplevdes som faktiskt värdelös igår kväll	negativ
Slutet framstod som ganska tråkig	negativ
Rullen upplevdes som ganska ointressant utan tvekan	negativ
Rullen verkade alldeles för magisk igår kväll	positiv
Hela filmen blev helt fantastisk hela tiden	positiv
Manuset kändes ganska tråkig idag	negativ
Manuset verkade alldeles för fånig	negativ
Slutet upplevdes som faktiskt medel	neutral
Hela filmen verkade väldigt utmärkt idag	positiv
Berättelsen kändes faktiskt okej igår kväll	neutral
Denna film upplevdes som ganska fånig	negativ
Handlingen upplevdes som helt halvbra utan tvekan	neutral
Slutet blev alldeles för mäktig	positiv
Filmen kändes mest magisk idag	positiv
Upplevelsen upplevdes som riktigt fantastisk	positiv
Regin verkade lite väl spännande	positiv
Rullen upplevdes som ganska usel för min smak	negativ
Hela filmen verkade faktiskt rörig	negativ
Berättelsen kändes faktiskt fantastisk hela tiden	positiv
Skådespelet verkade ganska tråkig hela tiden	negativ
Filmen upplevdes som otroligt seg att titta på	negativ
Hela filmen var väldigt bedrövlig	negativ
Hela filmen kändes otroligt fruktansvärd	negativ
Skådespelet var alldeles för okej	neutral
Upplevelsen kändes alldeles för godkänd att titta på	neutral
Handlingen blev lite väl godkänd	neutral
Berättelsen kändes lite väl lagom att titta på	neutral
Dialogen upplevdes som ganska långtråkig för min smak	negativ
Dialogen var mest lagom utan tvekan	neutral
Upplevelsen blev lite väl passabel att titta på	neutral
Regin var helt underbar hela tiden	positiv
Upplevelsen verkade helt magisk från början till slut	positiv
Dialogen upplevdes som väldigt långtråkig	negativ
Hela filmen framstod som ointressant	negativ
Berättelsen kändes lite väl rolig	positiv
Dialogen upplevdes som riktigt okej	neutral
Upplevelsen blev lite väl spännande	positiv
Skådespelet kändes alldeles för bedrövlig utan tvekan	negativ
Regin verkade alldeles för som väntat i biosalongen	neutral
Rullen verkade riktigt som väntat	neutral
Slutet framstod som helt lagom	neutral
Berättelsen verkade alldeles för bedrövlig	negativ
Slutet kändes faktiskt medel idag	neutral
Handlingen kändes alldeles för lagom	neutral
Dialogen upplevdes som mest passabel	neutral
Hela filmen kändes helt bedrövlig	negativ
Hela filmen framstod som riktigt medel utan tvekan	neutral
Upplevelsen var alldeles för godkänd igår kväll	neutral
Handlingen var alldeles för smart	positiv
Manuset upplevdes som otroligt fånig	negativ
Skådespelet blev otroligt seg att titta på	negativ
Slutet var mest godkänd från början till slut	neutral
Skådespelet verkade faktiskt smart igår kväll	positiv
Berättelsen verkade lite väl seg igår kväll	negativ
Berättelsen framstod som lite väl som väntat	neutral
Skådespelet kändes otroligt halvbra från början till slut	neutral
Slutet verkade helt lagom hela tiden	neutral
Upplevelsen blev mest gripande att titta på	positiv
Handlingen framstod som mest stark i sin helhet	positiv
Filmen upplevdes som ganska lysande i sin helhet	positiv
Skådespelet framstod som ganska rörig i biosalongen	negativ
Upplevelsen verkade lite väl som väntat	neutral
Hela filmen kändes mest välgjord	positiv
Hela filmen verkade väldigt passabel att titta på	neutral
Berättelsen var helt godkänd utan tvekan	neutral
Manuset upplevdes som alldeles för godkänd	neutral
Handlingen framstod som faktiskt tråkig	negativ
Rullen upplevdes som ganska lysande på alla sätt	positiv
Dialogen framstod som alldeles för okej igår kväll	neutral
Handlingen framstod som alldeles för usel	negativ
Slutet upplevdes som riktigt okej	neutral
Hela filmen blev helt platt i biosalongen	negativ
Slutet upplevdes som ganska seg	negativ
Slutet upplevdes som mest ointressant i sin helhet	negativ
Skådespelet var alldeles för typisk	neutral
Skådespelet kändes väldigt typisk igår kväll	neutral
Denna film verkade helt acceptabel i biosalongen	neutral
Hela filmen verkade helt underbar	positiv
Berättelsen upplevdes som faktiskt lagom	neutral
Slutet framstod som otroligt fantastisk	positiv
Upplevelsen verkade mest spännande igår kväll	positiv
Upplevelsen kändes helt medel på alla sätt	neutral
Regin kändes mest vanlig för min smak	neutral
Regin verkade väldigt fruktansvärd igår kväll	negativ
Skådespelet framstod som riktigt lysande	positiv
Handlingen verkade mest acceptabel hela tiden	neutral
Filmen blev ganska underbar på alla sätt	positiv
Denna film framstod som väldigt lagom	neutral
Berättelsen framstod som lite väl okej	neutral
Rullen upplevdes som alldeles för lagom	neutral
Manuset blev alldeles för fantastisk utan tvekan	positiv
Handlingen upplevdes som riktigt seg	negativ
Regin verkade lite väl rolig hela tiden	positiv
Skådespelet framstod som riktigt godkänd	neutral
Hela filmen var mest fånig	negativ
Handlingen var alldeles för lysande på alla sätt	positiv
Regin var faktiskt tråkig utan tvekan	negativ
Filmen verkade lite väl tråkig för min smak	negativ
Hela filmen var ganska dålig	negativ
Slutet verkade faktiskt utmärkt för min smak	positiv
Hela filmen kändes lite väl välgjord idag	positiv
Regin verkade lite väl långtråkig	negativ
Rullen upplevdes som alldeles för bedrövlig	negativ
Rullen framstod som lite väl lagom igår kväll	neutral
Handlingen framstod som väldigt usel	negativ
Skådespelet kändes riktigt passabel att titta på	neutral
Slutet verkade ganska seg från början till slut	negativ
Upplevelsen upplevdes som helt fånig hela tiden	negativ
Upplevelsen verkade alldeles för tråkig	negativ
Rullen upplevdes som faktiskt gripande på alla sätt	positiv
Denna film verkade helt typisk för min smak	neutral
Dialogen blev alldeles för gripande	positiv
Manuset framstod som otroligt smart idag	positiv
Manuset upplevdes som faktiskt seg hela tiden	negativ
Upplevelsen upplevdes som mest välgjord att titta på	positiv
Slutet kändes alldeles för acceptabel idag	neutral
Dialogen upplevdes som faktiskt fantastisk i sin helhet	positiv
Manuset verkade väldigt mäktig hela tiden	positiv
Denna film upplevdes som helt ointressant	negativ
Rullen framstod som helt fantastisk	positiv
Slutet kändes otroligt seg idag	negativ
Skådespelet upplevdes som ganska godkänd	neutral
Berättelsen framstod som ganska stark	positiv
Denna film kändes helt spännande	positiv
Berättelsen framstod som alldeles för mäktig	positiv
Berättelsen var lite väl okej igår kväll	neutral
Filmen upplevdes som mest acceptabel i biosalongen	neutral
Manuset framstod som lite väl magisk	positiv
Slutet blev ganska alldaglig utan tvekan	neutral
Skådespelet blev ganska rörig idag	negativ
Upplevelsen framstod som riktigt platt	negativ
Handlingen framstod som ganska godkänd utan tvekan	neutral
Skådespelet blev alldeles för fånig utan tvekan	negativ
Slutet kändes helt fantastisk att titta på	positiv
Berättelsen kändes ganska smart på alla sätt	positiv
Regin upplevdes som helt lagom på alla sätt	neutral
Handlingen upplevdes som alldeles för tråkig hela tiden	negativ
Skådespelet verkade alldeles för fånig	negativ
Berättelsen kändes faktiskt magisk att titta på	positiv
Berättelsen upplevdes som otroligt ointressant hela tiden	negativ
Manuset upplevdes som lite väl utmärkt	positiv
Denna film verkade väldigt dålig hela tiden	negativ
Regin blev alldeles för fånig	negativ
Denna film framstod som typisk	neutral
Regin blev mest värdelös i biosalongen	negativ
Denna film upplevdes som faktiskt gripande utan tvekan	positiv
Regin blev faktiskt som väntat på alla sätt	neutral
Denna film upplevdes som väldigt utmärkt	positiv
Hela filmen upplevdes som magisk	positiv
Dialogen var lite väl fantastisk i sin helhet	positiv
Berättelsen upplevdes som som väntat	neutral
Dialogen verkade alldeles för ointressant igår kväll	negativ
Dialogen verkade helt platt för min smak	negativ
Skådespelet upplevdes som otroligt medel utan tvekan	neutral
Handlingen framstod som väldigt platt	negativ
Denna film upplevdes som faktiskt platt	negativ
Manuset blev mest halvbra från början till slut	neutral
Upplevelsen verkade ganska bedrövlig att titta på	negativ
Regin kändes helt lagom hela tiden	neutral
Filmen var mest som väntat igår kväll	neutral
Skådespelet blev faktiskt stark utan tvekan	positiv
Slutet kändes mest dålig att titta på	negativ
Manuset verkade faktiskt smart i sin helhet	positiv
Slutet blev helt magisk från början till slut	positiv
Manuset kändes faktiskt dålig hela tiden	negativ
Filmen kändes riktigt utmärkt att titta på	positiv
Manuset framstod som mest lagom idag	neutral
Denna film upplevdes som alldaglig	neutral
Denna film var mest lagom	neutral
Denna film var mest godkänd	neutral
Filmen verkade helt godkänd hela tiden	neutral
Upplevelsen blev lite väl fånig	negativ
